-----------------###.#..#..#..#..#..###-------------..#.####...####--####...###-------------...###------------
------------------##................###-------------...####......######......##-------------#...##------------
-----------------##..##############..##-------#######...#######...####...######-------------##...##-----------
-----------------##..##############..##-----##########...##.####...##...####.##-------------.##..##-----------
-----------------##..##############..##-----#......####..##..####......####..##-------------..##.##-----------
-----------------###......####......###----#...#.....##..##...####....####...##------------#...####-----------
-----------------####.....####.....####----#..#####......###...####..####...###------------#...####-----------
-------------------###....####....####----##..######.....####...########...####-----------###...#-------------
--------------------####..####..#####-----##..##-#############...######...####------------###...--------------
--------------------####..####..####------##..##--############...######...###------------###...#--------------
----------------------##..####..##--------##..######.....####...########...####--------####...#---------------
----------------------##..####..##--------##..#####......###...####..####...###------#####...##---------------
--###..---------------##..####..##---------#...#.....##..##...####....####...##----#####...###----------------
--..###....####-------##..####..##---------##......####..##..####......####..##--#####...###..----------------
-#....###...############..####..##----------##########...##.####...##...####.#######...###....#---------------
###.....###..###########..####..##----------#########...#######...####...#########...###.....####------------#
##...##...###..###.###.#........##------------------...#.##......######......###...###...##...#####--------###
#...####....###..###.#####.##.####------------------.#####.##..####-#####..####..###....####...####--------###
##################################-------##########################--###########################.##--------##.
################################---------########################----#####################-########--------###
.####......##..###.....#######----------###...........###-------#########....##----------.##....###--------###
##.#...##...##...###.....###########--####...###.###...####-###########....####---##..#--#.....###----------##
###...####...##..#####.......#######-####...##..#..##...###-######.......######---##..#-##..######----------##
##...######...##.########.........######...##.......##...#####.........######-----##..####..####-------------#
#...##.##.##...####-#########......####.....##.....##...#####......########-------##..####..##-------------###
...##.####.##...###----##########...##.......##...##...##.##...##########-------####..####..##-------------###
..##.##..##.##...##----------#######.#####....##.##...#####.#########--------#######..####..##-------------##.
.##.##.##.##.##..###-----------########..###...###..###..########------------#####....####....-------------##.
##.##..##..##.##.###--------------#####....##...#..##....#####---------------##.......####....-------------##.
#.##..####..##.##.##-----------------####....##...##...####------------------####.##..####..#--------------###
......####.......###-------------------.###...####...###.##------------------##.##.##..##..##--------------##.
##....####....######---------------------###...##...###..##------------------##..##.##.##.##---------------###
####..####..######------------------------###......###...##------------------###..##.##..##.---------------###
####..####..####--------------------------..###...###...###-------------------###...##.##.##..----------------
####..####..#######-------------------------.######...#####-------------------####...######...---------------#
####..####..#######--------------------------.####...#####---------------------####...####...###-------------#
#.....#..#...##..##----------------------------##...####------------------------####...##...######----------##
...###.##.###....##----------------------------##...###--------------------------####......##.####----------##
.####################################-####################-------------------------############.###--------###
##################-########################################------------------------################--------###
#####################..##..##..##..#####.##.##.##.##.##.###----------------------------------###.##--------##.
..............#.####..##..##..##..##.##.#..#..#..#..#..#.##---------------------------........#.###--------###
.############.#.###..##..##..##..##...#.#..#..#..#..#..#.##---------------------------#######.#.###--------###
.#..........#.#.###.##..##..##..##..####.##.##.##.##.##.###--------------------------.......#.#.##----------##
.#.########.#.#.#####..##..##..##..####..................##--------------------------######.#.#.##----------##
.#.#......#.#.#.####..##..##..##..##.##.################.##-------------------------......#.#.#.------------##
.#.#.####.#.#.#.###..##..##..##..##..##.################.##-------------------##.#.#.####.#.#.--------------##
.#.#.#..#.#.#.#.###.##..##..##..##..###..................##-------------------##.#.#.#..#.#.----------------##
.#.#.#.##.#.#.#.#.###..##..##..##..###########.############-------------------##.#.#.#.##-------------------##
.#.#.#.##.#.#.#.####..##..##..##..##.##......#...........##-------------------##.#.#.#.##-------------------##
.#.#.#....#.#.#.###..##..##..##..##..##.################.##-------------------##.#.#.#.---------------------##
.#.#.######.#.#.###.##..##..##..##..###................#.##-------------------##.#.#.-----------------------##
.#.#........#.#.#####..##..##..##..####.#####.########.#.##-------------------##.#.#.-----------------------##
.#.##########.#.####..##..##..##..##.##.....#.#........#.##.##..##..##..##..####.#.##-----------------------##
.#............#.###..##..##..##..##..########.#######.#..##..##..##..##..##..###.#...-----------------------##
.##############.###.##..##..##..##..###.............#...P###..##..##..##..##.###.####-----------------------##
................#####..##..##..##..####.#############.#..#K##..##..##..##..####....-------------------------##
####################..##..##..##..##.##................####.##..##..##..##..#.####--------------------------##
#################-################################################################---------------------------#
------------------######################################-------------------#####------------------------------
--------------------------------------------------------------------------------------------------------------
--------------------------------------------------------------------------------------------------------------
--------------------------------------------------------------------------------------------------------------
--------------------------------------------------------------------------------------------------------------
--------------------------------------------------------------------------------------------------------------
--------------------------------------------------------------------------------------------------------------
--------------------------------------------------------------------------------------------------------------
--------------------------------------------------------------------------------------------------------------
-----------------------------------------------------------------#####---------------#####--------------------
---------------------------------------------------------------#########-----------#########------------------
-------------------------------------------------------------######.######-------######.######----------------
-----------------------------------------------------------######.###.######---######.###.######--------------
-----------------------------------------------------------####.#######.######-####.#######.######------------
----------------------------------------------------------###.###########.#######.###########.####------------
----------------------------------------------------------########---######.##########---######.##------------
---------------------------------------------------------###.###-------#########.###-------########-----------
---------------------------------------------------------######---------##.###.#####--------##.####-----------
---------------------------------------------------------##.#.#---------####.##.#.##--------####.##-----------
---------------------------------------------------------########-------.############-------.######-----------
---------------------------------------------------------###.######------##.####.######------##.###-----------
----------------------------------------------------------####.######----#.#######.######----#.####-----------
----------------------------------------------------------######.######--###.#######.######--###.##-----------
------------------------------------------------------------######.######-.####-######.######-.####-----------
--------------------------------------------------------------######.##########---######.##########-----------
----------------------------------------------------------------######.######-------######.######-------------
------------------------------------------------------------------######.######-------######.######-----------
--------------------------------------------------------------------######.####---------######.####-----------
----------------------------------------------------------------------######.##-----------######.##-----------
----------------------------------------------------------------------#########------------########-----------
---------------------------------------------------------------------######.###------------####.###-----------
---------------------------------------------------------------------###.#####-------------##.####------------
---------------------------------------------------------------------##.##.###-------------####.###-----------
---------------------------------------------------------------------####.###--------------########-----------
---------------------------------------------------------------------###.####----------------###.##-----------
----------------------------------------------------------------------####.###-------------########-----------
----------------------------------------------------------------------########-----------######.###-----------
------------------------------------------------------------------------###.###--------######.####------------
-------------------------------------------------------------------------######------######.######------------
---------------------------------------------------------###################.##----######.######--------------
---------------------------------------------------------##############################.######----------------
---------------------------------------------------------##..................########.######------------------
---------------------------------------------------------##..................##.###.######--------------------
-----------------##########################.--------.#######################.##...######----------------------
-----------------############################.----.#############################....###########---------------
-----------------##..................##...############...##..................#####....#########---------------
-----------------##.#.#.#.#.#.#.#.#..###....########....###.#.#.#.#.#.#.#.#..##..###....####.###--------------
-----------------##..#.#.#.#.#.#.#.#.###.......##......####..#.#.#.#.#.#.#.#.##....###....########------------
-----------------##..................#.####.....#....#.####..................##......###....#.####------------
-----------------##.####################################.########------#####.##################.##------------
-----------------########################----######################--#############################------------
